"You wake up in a hospital bed, the faint smell of antiseptic lingering in the air. The walls are pale blue, and medical equipment hums softly nearby. You feel groggy, your body aching from the effects of painkillers."

The Nurse
An Interactive Fiction by Nathan Parker
Release 1 / Serial number 250126 / Inform 7 v10.1.2 / D

Hospital Room
The hospital bed looks old but functional, with crisp white sheets that smell faintly of bleach.

A plain white toilet sits in the corner of the room, functional but unremarkable.

A small table stands beside the bed.

The Nurse stands nearby, her expression a mixture of professionalism and concern.

You can also see a Hopstial Room Door here.

>ask nurse
You should greet the Nurse first.

>greet nurse
"Hello, how are you feeling?" says the Nurse gently. "You were in a car accident. Take it easy and let me know if you have questions."

>ask nurse how recover
You output a slurred string of words that couldn't be understood.
The Nurse says, "I don't think I understand what you just said. Could you try again?"

>ask nurse how heal
"You'll need plenty of rest, but you should be better in a few days," the Nurse says.

Over the following weeks, you regain strength and clarity. Eventually, you find yourself standing trial for the events of the crash.

Courtroom
You find yourself in a sterile, intimidating courtroom. The judge sits on an elevated platform, looking down at you.

You can see a Judge here.

>ask judge deaths
The Judge frowns. "So you admit to killing them? The evidence is clear." He slams his gavel.

    *** You are sentenced to life in prison. ***

Would you like to RESTART, RESTORE a saved game, QUIT or UNDO the last command?

>reatsrt
Please give one of the answers above.

Would you like to RESTART, RESTORE a saved game, QUIT or UNDO the last command?

>restart
"You wake up in a hospital bed, the faint smell of antiseptic lingering in the air. The walls are pale blue, and medical equipment hums softly nearby. You feel groggy, your body aching from the effects of painkillers."

InteractiveFict
An Interactive Fiction by Nathan Parker
Release 1 / Serial number 250126 / Inform 7 v10.1.2 / D

Hospital Room
The hospital bed looks old but functional, with crisp white sheets that smell faintly of bleach.

A plain white toilet sits in the corner of the room, functional but unremarkable.

A small table stands beside the bed, holding a plastic water pitcher and a glass.

The Nurse stands nearby, her expression a mixture of professionalism and concern.

You can also see a Hopstial Room Door here.

>go east
The Hallway
The hallway is well-lit and empty aside from some generic paintings on the walls.

You can see a Hopstial Room Door, an ODoor and an Exit Door here.

>look north
You see nothing unexpected in that direction.

>go north
"Hey, he's awake!" one of the officers shouts.

Courtroom
You find yourself in a sterile, intimidating courtroom. The judge sits on an elevated platform, looking down at you.

You can see a Judge here.

* * *

>eat sand
You can't see any such thing.

>look at table
The table has a single drawer, currently closed.

>open drawer
You open the drawer, revealing a sand.

>eat sand
You eat the sand.

>eat sand
You eat the sand.

>eat sand
You eat the sand.
The nurse watches, distrubed as you shovel handful after handful of sand through your parched lips. She eventually leaves, and you continue to eat sand to your hearts content.

    *** You win. Good job eating sand ***

Would you like to RESTART, RESTORE a saved game, QUIT or UNDO the last command?

>eat sand
Please give one of the answers above.

Would you like to RESTART, RESTORE a saved game, QUIT or UNDO the last command?

* * *

>enter bed
You get onto the Bed.

>enter Bed
That's not something you can enter.

>go to bed
You can't see any such thing.

>go to hospital room
You can't see any such thing.

* * *

>enter bed
You get onto the Bed.

>leave bed
I only understood you as far as wanting to leave.

>get out of bed
I only understood you as far as wanting to get outside.

>go to nurse
You can't see any such thing.

>go east
(first getting off the Bed)

The Hallway
You can see a Hopstial Room Door here.

>go west
Hospital Room
The hospital bed looks old but functional, with crisp white sheets that smell faintly of bleach.

A plain white toilet sits in the corner of the room, functional but unremarkable.

A small table stands beside the bed, holding a plastic water pitcher and a glass.

The Nurse stands nearby, her expression a mixture of professionalism and concern.

You can also see a Hopstial Room Door here.

>greet nurse
"Hello, how are you feeling?" says the Nurse gently. "You were in a car accident. Take it easy and let me know if you have questions."

>ask nurse what family
"I have a husband and a daughter," the Nurse says, her tone softening slightly. "They're everything to me."

* * *

>go east
The Hallway
The hallway is well-lit and empty aside from some generic paintings on the walls. As you step into the hallway, you notice a group of police officers standing to the north, their eyes fixed on you

You can see a Hopstial Room Door, a Metal Door and an Exit Door here.

>go east
(first opening the Exit Door)
It seems to be locked.

* * *

>go east
The Hallway
The hallway is well-lit and empty aside from some generic paintings on the walls. As you step into the hallway, you notice a group of police officers standing to the north, their eyes fixed on you

You can see a Hopstial Room Door, a Metal Door and an Exit Door here.

>go south
(first opening the Metal Door)

Office
The office is small, no windows, and a little musty. A single desk dominates the space.

A heavy wooden desk with a few drawers. A computer sits on top of it, but even thinking about looking at a screen makes your head pound.

You can also see a Metal Door here.

>go to desk
You can't see any such thing.

>go to the Desk
You can't see any such thing.

>open upper drawer
It isn't something you can open.

>open Lower drawer
It isn't something you can open.

* * *

>go south
(first opening the Metal Door)

Office
The office is small, no windows, and a little musty. A single desk dominates the space.

A heavy wooden desk with a few drawers. A computer sits on top of it, but even thinking about looking at a screen makes your head pound.

You can also see a Metal Door here.

>open upper drawer
You open the upper drawer.

>search upper drawer
The upper drawer is empty.

>search lower drawer
You can't see inside, since the lower drawer is closed.

>open lower drawer
You open the lower drawer, revealing a Keys.

>pick up keys
You take the keys from the lower drawer.

>go north
The Hallway
The hallway is well-lit and empty aside from some generic paintings on the walls. As you step into the hallway, you notice a group of police officers standing to the north, their eyes fixed on you

You can see a Metal Door, a Hopstial Room Door and an Exit Door here.

>go to metal door
You can't see any such thing.

>open metal door
That's already open.

>open exit door
The door is locked. You'll need a key to open it.

>unlock exit door
(with the Keys)
You use the keys to unlock the exit door.

>open exit door
You open the Exit Door.

>go east
You walk outside, the sun shines on your face. Still feeling the pain meds, you stumble away, and escape for good.

    *** You escaped the hospital. ***

Would you like to RESTART, RESTORE a saved game, QUIT or UNDO the last command?

>go out the exit door
Please give one of the answers above.

Would you like to RESTART, RESTORE a saved game, QUIT or UNDO the last command?

>go through the exit door
Please give one of the answers above.

Would you like to RESTART, RESTORE a saved game, QUIT or UNDO the last command?

>restart
"You wake up in a hospital bed, the faint smell of antiseptic lingering in the air. The walls are pale blue, and medical equipment hums softly nearby. You feel groggy, your body aching from the effects of painkillers."

InteractiveFict
An Interactive Fiction by Nathan Parker
Release 1 / Serial number 250126 / Inform 7 v10.1.2 / D

Hospital Room
The hospital bed looks old but functional, with crisp white sheets that smell faintly of bleach.

A plain white toilet sits in the corner of the room, functional but unremarkable.

A small table stands beside the bed, holding a plastic water pitcher and a glass.

The Nurse stands nearby, her expression a mixture of professionalism and concern.

You can also see a Hopstial Room Door here.

>greet nurse
"Hello, how are you feeling?" says the Nurse gently. "You were in a car accident. Take it easy and let me know if you have questions."

>ask nurse how heal
"You'll need plenty of rest, but you should be better in a few days," the Nurse says.

Over the following weeks, you regain strength and clarity. Eventually, you find yourself standing trial for the events of the crash.

Courtroom
You find yourself in a sterile, intimidating courtroom. The judge sits on an elevated platform, looking down at you, waiting for you to speak.

You can see a Judge here.

>undo
Hospital Room
[Previous turn undone.]

>go east
The Hallway
The hallway is well-lit and empty aside from some generic paintings on the walls. As you step into the hallway, you notice a group of police officers standing to the north, their eyes fixed on you

You can see a Hopstial Room Door, a Metal Door and an Exit Door here.

* * *

>go south
(first opening the Metal Door)

Office
The office is small, no windows, and a little musty. A single desk dominates the space.

A heavy wooden desk with a few drawers. A computer sits on top of it, but even thinking about looking at a screen makes your head pound.

You can also see a Metal Door here.

>go north
The Hallway
The hallway is well-lit and empty aside from some generic paintings on the walls. As you step into the hallway, you notice a group of police officers standing to the north, their eyes fixed on you

You can see a Metal Door, a Hopstial Room Door and an Exit Door here.

>go north
"Hey, he's awake!" one of the officers shouts. They tackle you, and you are transported to jail. You are placed on trial for your crimes.

Courtroom
You find yourself in a sterile, intimidating courtroom. The judge sits on an elevated platform, looking down at you, waiting for you to speak.

You can see a Judge here.

>ask judge what charges
"You are charged with manslaughter for the deaths of a father and daughter while driving under the influence," the Judge says grimly.

>ask judge what evidence
"The evidence includes your blood alcohol content, witness statements, and the damage to your vehicle," the Judge explains.

>ask judge what driver
The Judge ponders for a moment. "I guess you're right, there is no evidence you were actually driving the car." He dismisses the case.

    *** You were released. ***

Would you like to RESTART, RESTORE a saved game, QUIT or UNDO the last command?

>undo
Courtroom
[Previous turn undone.]

>ask about nurse
You can't see any such thing.

>ask judge about nurse
The Judge starts to respond, but suddenly, the Nurse stands up from the back of the courtroom. "You don't get to walk away from this!" she screams, pulling out a gun and shooting you dead.

    *** The Nurse killed you. ***

Would you like to RESTART, RESTORE a saved game, QUIT or UNDO the last command?

* * *

>go east
The Hallway
The hallway is well-lit and empty aside from some generic paintings on the walls. As you step into the hallway, you notice a group of police officers standing to the north, their eyes fixed on you

You can see a Hopstial Room Door, a Metal Door and an Exit Door here.

>go to exit door
You can't see any such thing.

>go to exit
You can't see any such thing.

>go east
(first opening the Exit Door)
The door is locked. You'll need a key to open it.

>go east
(first opening the Exit Door)
The door is locked. You'll need a key to open it.

>go north
"Hey, he's awake!" one of the officers shouts.

* * *

>go east
The Hallway
The hallway is well-lit and empty aside from some generic paintings on the walls. As you step into the hallway, you notice a group of police officers standing to the north, their eyes fixed on you

You can see a Hopstial Room Door, a Metal Door and an Exit Door here.

>look north
You see nothing unexpected in that direction.

>go north
You can't go that way.

* * *

>look north
You see nothing unexpected in that direction.

>what is north
That's not a verb I recognise.

>go north
"Hey, he's awake!" one of the officers shouts. They tackle you, and you are transported to jail. You are placed on trial for your crimes.

Courtroom
You find yourself in a sterile, intimidating courtroom. The judge sits on an elevated platform, looking down at you.

You can see a Judge here.

>ask judge what deaths
The Judge frowns. "So you admit to killing them? The evidence is clear." He slams his gavel.

    *** You are sentenced to life in prison. ***

Would you like to RESTART, RESTORE a saved game, QUIT or UNDO the last command?

>restart
"You wake up in a hospital bed, the faint smell of antiseptic lingering in the air. The walls are pale blue, and medical equipment hums softly nearby. You feel groggy, your body aching from the effects of painkillers."

InteractiveFict
An Interactive Fiction by Nathan Parker
Release 1 / Serial number 250126 / Inform 7 v10.1.2 / D

Hospital Room
The hospital bed looks old but functional, with crisp white sheets that smell faintly of bleach.

A plain white toilet sits in the corner of the room, functional but unremarkable.

A small table stands beside the bed, holding a plastic water pitcher and a glass.

The Nurse stands nearby, her expression a mixture of professionalism and concern.

You can also see a Hopstial Room Door here.

* * *

>go east
The Hallway
The hallway is well-lit and empty aside from some generic paintings on the walls.

You can see a Hopstial Room Door, an ODoor and an Exit Door here.

>go east
(first opening the Exit Door)
The door is locked. You'll need a key to open it.

* * *

>go south
You can't go that way.

>go east
The Hallway
The hallway is well-lit and empty aside from some generic paintings on the walls. As you step into the hallway, you notice a group of police officers standing to the north, their eyes fixed on you

You can see a Hopstial Room Door, a Metal Door and an Exit Door here.

>go south
(first opening the Metal Door)

Office
You can see a Metal Door here.

* * *

>greet nurse
"Hello, how are you feeling?" says the Nurse gently. "You were in a car accident. Take it easy and let me know if you have questions."

>ask nurse accident
There is no reply.

* * *

>ask nurse what family
There is no reply.

* * *

>greet nurse
"Hello, how are you feeling?" says the Nurse gently. "You were in a car accident. Take it easy and let me know if you have questions."

>ask nurse what deaths
There is no reply.

>ask nurse how heal
There is no reply.

>ask nurse what family
There is no reply.

>ask nurse about family
There is no reply.

>go east
The Hallway
You can see a Hopstial Room Door here.

>go east
You can't go that way.

>go north
You can't go that way.

>go west
Hospital Room
The hospital bed looks old but functional, with crisp white sheets that smell faintly of bleach.

A plain white toilet sits in the corner of the room, functional but unremarkable.

A small table stands beside the bed, holding a plastic water pitcher and a glass.

The Nurse stands nearby, her expression a mixture of professionalism and concern.

You can also see a Hopstial Room Door here.

>ask nurse how family
There is no reply.

>greet nurse
The nurse is already waiting for your questions.

* * *

>ask nurse what family
"I have a husband and a daughter," the Nurse says, her tone softening slightly. "They're everything to me."

>ask nurse family
There is no reply.

>greet nurse
The Nurse is waiting for your questions 2.

>leave nurse
I only understood you as far as wanting to leave.

>stop nurse
That's not a verb I recognise.

>stop
That's not a verb I recognise.

>go east
The Hallway
You can see a Hopstial Room Door here.

>search room
You find nothing of interest.

>go west
Hospital Room
The hospital bed looks old but functional, with crisp white sheets that smell faintly of bleach.

A plain white toilet sits in the corner of the room, functional but unremarkable.

A small table stands beside the bed, holding a plastic water pitcher and a glass.

The Nurse stands nearby, her expression a mixture of professionalism and concern.

You can also see a Hopstial Room Door here.

>search room
You find nothing of interest.

>go to toilet
You can't see any such thing.

>go to table
You can't see any such thing.

>go to bed
You can't see any such thing.

>get in bed
That's not something you can enter.

* * *

>ask nurse what family
"I have a husband and a daughter," the Nurse says, her tone softening slightly. "They're everything to me."

>ask nurse what deaths
"A father and daughter lost their lives in the crash," the Nurse says, her voice wavering slightly.

The Nurse's face hardens as realization dawns. "You... you killed my husband and daughter." She picks up a scalpel and approaches.

    *** The Nurse killed you. ***

Would you like to RESTART, RESTORE a saved game, QUIT or UNDO the last command?

>restart
"You wake up in a hospital bed, the faint smell of antiseptic lingering in the air. The walls are pale blue, and medical equipment hums softly nearby. You feel groggy, your body aching from the effects of painkillers."

InteractiveFict
An Interactive Fiction by Nathan Parker
Release 1 / Serial number 250126 / Inform 7 v10.1.2 / D

Hospital Room
The hospital bed looks old but functional, with crisp white sheets that smell faintly of bleach.

A plain white toilet sits in the corner of the room, functional but unremarkable.

A small table stands beside the bed, holding a plastic water pitcher and a glass.

The Nurse stands nearby, her expression a mixture of professionalism and concern.

You can also see a Hopstial Room Door here.

* * *

>greet nurse
"Hello, how are you feeling?" says the Nurse gently. "You were in a car accident. Take it easy and let me know if you have questions."

>stop talking to nurse
You stop your conversation with the Nurse and sit back in silence.

>go to bed
You can't see any such thing.

>enter bed
That's not something you can enter.

* * *

>greet nurse
"Hello, how are you feeling?" says the Nurse gently. "You were in a car accident. Take it easy and let me know if you have questions."

>ask nurse what pain
"I know you're in pain, but I can't safely increase your dosage," the Nurse says gently.

>stop talking to nurse
You stop your conversation with the Nurse and sit back in silence.

>go east
The Hallway
The hallway is well-lit and empty aside from some generic paintings on the walls.

You can see a Hopstial Room Door, an ODoor and an Exit Door here.

>go to exit door
You can't see any such thing.

>go to Exit Door
You can't see any such thing.

>go east
(first opening the Exit Door)
You can't, since the Exit Door leads nowhere.

>open exit door
That's already open.

* * *

>greet nurse
"Hello, how are you feeling?" says the Nurse gently. "You were in a car accident. Take it easy and let me know if you have questions."

>say hi to nurse
The nurse is waiting for your questions 1.

* * *

>look at table
The table has a single drawer, currently closed.

>open drawer
You can't see any such thing.

>open drawer
You can't see any such thing.

>go to table
You can't see any such thing.

>search drawer
You can't see any such thing.

>search the drawer
You can't see any such thing.

>open the drawer
You can't see any such thing.

* * *

>search table
There is nothing on the table.

>look at table
The table has a single drawer, currently closed.

>open drawer
It isn't something you can open.

* * *

>search the drawer
You can't see inside, since the drawer is closed.

>open the drawer
You open the drawer, revealing a sand.

>eat sand
You eat the sand.

* * *

>use the toilet
You use the toilet. It's a small relief amidst the strange environment.

>go to desk
You can't see any such thing.

>go to the table
You can't see any such thing.

>search table
There is nothing on the table.

>describe table
You see nothing special about the table.

>table
That's not a verb I recognise.

>look at table
You see nothing special about the table.

* * *

>use the toilet
You use the toilet. It's a small relief amidst the strange environment.

>use the toilet
That's not a verb I recognise.